000000000000000000000000000000
011111111111111111111111111110
010000000000000000000000000010
010000000020020020020000000010
010000200000000000000002000010
010000000000000000000000000010
010002000001111111100000200010
010000000010000000010000000010
010002000100000000001000200010
010002000100000000001000200010
010000000010000000010000000010
010002000001111111100000200010
010000000000000000000000000010
010000200000000000000002000010
010000000020000000020000000010
010000000000000000000000000010
011111111111111111111111111110
000000000000000000000000000000